++++++++++
+S       +
+  ++++  +
+     +  +
++++  +  +
+     +  +
+  ++++  +
+        +
+++++++++E
