++++++++++++
+S        ++
+++++++ ++++
+          +
+ ++++ + + +
+ +    + + +
+ + ++++ + +
+        + +
++++++++++++